k 2 2 2 2 2 2 2 2 l
3 g g g g g g g g 4
3 g g g g g g g g 4
3 g g g g g g g g 4
3 g g g g g g g g 4
3 g g g g g g g g 4
3 g g g g g g g g 4
3 g g g g g g g g 4
3 g g g g g g g g 4
i 1 1 1 1 1 1 1 1 o
